    #####
    #O  #
  ###  O##
  #  O O #
### # ## #   ######
#   # ## #####  xx#
# O  O          xx#
#####  ## #§##  xx#
    ###############
   