   ########
#### § # x#
#    # # x#
#    O # x#
#####O # x#
 #  #  x x#
 #O #  #  #
##  #O ####
# O O    #
#     #  #
##########